Achromobacter	neg
Acidovorax	neg
Acinetobacter	neg
Actinobacillus	neg
Actinobacteria	pos
Actinomyces	pos
Aermicrobium	pos
Aerococcus	pos
Aeromonas	neg
Aggregatibacter	neg
Agrobacterium	neg
Agrococcus	pos
Alcaligenes	neg
Anaerobiospirillum	neg
Anaerolinea	neg
Aneurinibacillus	pos
Arcanobacterium	pos
Arcobacter	neg
Arcticibacter	neg
Armatimonas	neg
Arthrobacter	pos
Aureimonas	neg
Azotobacter	neg
Bacillus	pos
Bacteroides	neg
Bartonella	neg
Bavariicoccus	pos
Bdellovibrio	neg
Bergeyella	neg
Bhargavaea	pos
Bifidobacterium	pos
Brachybacterium	pos
Brachyspira	neg
Bradyrhizobium	neg
Brevibacillus	pos
Brevibacterium	pos
Brevundimonas	neg
Brochothrix	pos
Budvicia	neg
Burkholderia	neg
Caldilinea	neg
Campylobacter	neg
Cardiobacterium	neg
Carnobacterium	pos
Cellulomonas	pos
Chromobacterium	neg
Chthonomonas	neg
Citrobacter	neg
Clostridium	pos
Comamonas	neg
Corynebacterium	pos
Coryneform	pos
Coxiella	neg
Cupriavidus	neg
Curtobacterium	pos
Cyanobacteria	neg
Cytophaga	neg
Dehalogenimonas	neg
Deinococcus	pos
Delftia	neg
Dermabacter	pos
Dermacoccus	pos
Desulfitobacterium	pos
Desulfurobacterium	neg
Devosia	neg
Dialister	neg
Dictyoglomus	neg
Dietzia	pos
Domibacillus	pos
Edwardsiella	neg
Elizabethkingia	neg
Empedobacter	neg
Enterobacter	neg
Enterococcus	pos
Erwinia	neg
Escherichia	neg
Exiguobacterium	pos
Fervidobacterium	pos
Fictibacillus	pos
Fimbriimonas	neg
Flavobacterium	neg
Fusobacterium	neg
Geobacillus	pos
Georgenia	pos
Globicatella	pos
Gordonia	pos
Haemophilus	neg
Hafnia	neg
Helicobacter	neg
Herbaspirillum	neg
Janibacter	pos
Kineococcus	pos
Klebsiella	neg
Kluyvera	neg
Kocuria	pos
Kozakia	neg
Kytococcus	pos
Lactobacillus	pos
Lactococcus	pos
Leclercia	neg
Legionella	neg
Leifsonia	pos
Lelliottia	neg
Leptonema	neg
Leptotrichia	neg
Leuconostoc	pos
Levilinea	neg
Listeria	pos
Luteimonas	neg
Lysinibacillus	pos
Massilia	neg
Megamonas	neg
Megasphaera	neg
Meiothermus	neg
Methylobacterium	neg
Microbacterium	pos
Microbispora	pos
Micrococcus	pos
Moraxella	neg
Morganella	neg
Mycobacterium	pos
Mycoplasma	neg
Myroides	neg
Negativicutes	neg
Neisseria	neg
Nitrosomonas	neg
Nocardia	pos
Oceanobacillus	pos
Ochrobactrum	neg
Oenococcus	pos
Oerskovia	pos
Oligella	neg
Ornithinibacillus	pos
Paenibacillus	pos
Pandoraea	neg
Pantoea	neg
Paracoccus	neg
Pasteuria	pos
Pasturella	neg
Pectinatus	neg
Pediococcus	pos
Pedobacter	neg
Pelosinus	neg
Pilibacter	pos
Plantibacter	pos
Pontibacter	neg
Propionibacterium	pos
Propionispora	neg
Proteobacteria	neg
Proteus	neg
Providencia	neg
Pseudomonas	neg
Pseudoxanthomonas	neg
Psychrobacillus	pos
Psychrobacter	neg
Pueribacillus	pos
Rahnella	neg
Ralstonia	neg
Raoultella	neg
Rathayibacter	pos
Rhizobium	neg
Rhodococcus	pos
Rickettsia	neg
Roseburia	pos
Roseomonas	neg
Rothia	pos
Saccharopolyspora	pos
Salinibacter	neg
Salmonella	neg
Samsonia	neg
Sarcina	pos
Serratia	neg
Shewanella	neg
Shigella	neg
Solibacillus	pos
Solobacterium	pos
Sorangium	neg
Sphaerotilus	neg
Sphingobacterium	neg
Sphingomonas	neg
Spirochaeta	neg
Sporolactobacillus	pos
Sporomusa	neg
Sporosarcina	pos
Staphylococcus	pos
Stenotrophomonas	neg
Strangles	pos
Streptococcus	pos
Streptomyces	pos
Syntrophomonas	pos
Tepidibacter	pos
Terribacillus	pos
Tetragenococcus	pos
Thermotoga	neg
Vagococcus	pos
Vampirococcus	neg
Veillonella	neg
Verminephrobacter	neg
Vibrio	neg
Victivallis	neg
Virgibacillus	pos
Vitreoscilla	neg
Weeksella	neg
Weissella	pos
Wolbachia	neg
Xanthomonas	neg
Yersinia	neg
Zymophilus	neg
